111111111111111111111111111111111111111111111111111111111111111111111111111111
1                                                             1              1
1                                                             1              1
1                                                             1              1
1                                                             1              1
1                                   1                         1              1
1                                  1 1                        1111111111111111
1                                 1   1                                      1
1                                1     1                                     1
1                               1       1                                    1
1                            111111111111111111                              1
1                           1                 1                              1
1                           1                 1                              1
1                        1111                 111111111                      1
11                                                    11111                111
1                                                          1111111           1
1                                                                1           1
1                     111111111111111                            1           1
1       X                       11111                            1           1
1                                  11                            1           1
1                                   111111                       1           1
1              11111                     111111                  1           1
1                                          1111                  1           1
1                                                             111111         1
1                                                                            1
1                             111111                                         1
1                   111111          1111111111                               1
1                                                                            1
1                                                                            1
1                                                                            1
1                                                                            1
111111111111111111111111111111111111111111111111111111111111111111111111111111